img/tilesMaps.png
1,0 2,0 3,0 3,0 3,0 3,0 3,0 3,0 3,0 3,0 3,0 3,0 3,0 3,0 3,0 3,0 3,0 3,0 3,0 3,0 3,0 3,0 3,0 3,0 3,0 1,0 2,0 3,0 3,0 3,0 3,0 3,0 3,0 3,0 3,0 3,0 3,0 3,0 3,0 3,0 3,0 3,0 3,0 3,0 3,0 3,0 3,0 3,0 3,0 3,0
1,1 2,1 3,1 3,1 3,1 3,1 3,1 3,1 3,1 3,1 3,1 3,1 3,1 3,1 3,1 3,1 3,1 3,1 3,1 3,1 3,1 3,1 3,1 3,1 3,1 1,1 2,1 3,1 3,1 3,1 3,1 3,1 3,1 3,1 3,1 3,1 3,1 3,1 3,1 3,1 3,1 3,1 3,1 3,1 3,1 3,1 3,1 3,1 3,1 3,1 
1,2 2,2 3,2 3,2 3,2 3,2 3,2 3,2 3,2 3,2 3,2 3,2 3,2 3,2 3,2 3,2 3,2 3,2 3,2 3,2 3,2 3,2 3,2 3,2 3,2 1,2 2,2 3,2 3,2 3,2 3,2 3,2 3,2 3,2 3,2 3,2 3,2 3,2 3,2 3,2 3,2 3,2 3,2 3,2 3,2 3,2 3,2 3,2 2,14 3,14 
1,2 2,3 3,3 3,3 3,3 3,3 3,3 3,3 3,3 3,3 3,3 3,3 3,3 3,3 3,3 3,3 3,3 3,3 3,3 3,3 3,3 3,3 3,3 3,3 3,3 1,2 2,3 3,3 3,3 3,3 3,3 3,3 3,3 3,3 3,3 3,3 3,3 3,3 3,3 3,3 3,3 3,3 3,3 3,3 3,3 3,3 3,3 3,3 2,15 3,15
1,4 2,4 3,4 1,4 2,4 3,4 1,4 2,4 3,4 1,4 2,4 3,4 1,4 2,4 3,4 1,4 2,4 3,4 1,4 2,4 3,4 1,4 2,4 3,4 1,4 1,4 2,4 3,4 1,4 2,4 3,4 1,4 2,4 3,4 1,4 2,4 3,4 1,4 2,4 3,4 1,4 2,4 3,4 1,4 2,4 3,4 1,4 2,4 3,4 1,4
1,5 2,5 3,5 1,5 2,5 3,5 1,5 2,5 3,5 1,5 2,5 3,5 1,5 2,5 3,5 1,5 2,5 3,5 1,5 2,5 3,5 1,5 2,5 3,5 1,5 1,5 2,5 3,5 1,5 2,5 3,5 1,5 2,5 3,5 1,5 2,5 3,5 1,5 2,5 3,5 1,5 2,5 3,5 1,5 2,5 3,5 1,5 2,5 3,5 1,5
1,4 2,4 3,4 1,4 2,4 3,4 1,4 2,4 3,4 1,4 2,4 3,4 1,4 2,4 3,4 1,4 2,4 3,4 1,6 2,6 3,4 1,4 2,4 3,4 1,4 1,4 2,4 3,4 1,4 2,4 3,4 1,4 2,4 3,4 1,4 2,4 3,4 1,4 2,4 3,4 1,4 2,4 3,4 1,6 2,6 3,4 1,4 2,4 3,4 1,4
1,5 2,5 3,5 1,5 2,5 3,5 1,5 2,5 3,5 1,5 2,5 3,5 1,5 2,5 3,5 1,5 2,5 3,5 1,5 2,5 3,5 1,5 2,5 3,5 1,5 1,5 2,5 3,5 1,5 2,5 3,5 1,5 2,5 3,5 1,5 2,5 3,5 1,5 2,5 3,5 1,5 2,5 3,5 1,5 2,5 3,5 1,5 2,5 3,5 1,5
1,4 2,4 3,4 1,4 2,4 3,4 1,4 2,4 3,4 1,4 2,4 3,4 1,4 2,4 3,4 1,4 2,4 3,4 1,4 2,4 3,4 1,4 2,4 3,4 1,4 1,4 2,4 3,4 1,4 2,4 3,4 1,4 2,4 3,4 1,4 2,4 3,4 1,4 2,4 3,4 1,4 2,4 3,4 1,4 2,4 3,4 1,4 2,4 3,4 1,4
1,5 2,5 3,5 1,5 2,5 3,5 1,5 2,5 3,5 1,5 2,5 3,5 1,5 2,5 3,5 1,5 2,5 3,5 1,5 2,5 3,5 1,5 2,5 3,5 1,5 1,5 2,5 3,5 1,5 2,5 3,5 1,5 2,5 3,5 1,5 2,5 3,5 1,5 2,5 3,5 1,5 2,5 3,5 1,5 2,5 3,5 1,5 2,5 3,5 1,5
1,6 2,6 3,4 1,4 2,4 3,4 1,6 2,6 3,4 1,4 2,4 3,4 1,4 2,4 3,4 1,4 2,4 3,4 1,4 2,4 3,4 1,4 2,4 3,4 1,4 1,6 2,6 3,4 1,4 2,4 3,4 1,6 2,6 3,4 1,4 2,4 3,4 1,4 2,4 3,4 1,4 2,4 3,4 1,4 2,4 3,4 1,4 2,4 3,4 1,4
1,5 2,5 3,5 1,5 2,5 3,5 1,5 2,5 3,5 1,5 2,5 3,5 1,5 2,5 3,5 1,5 2,5 3,5 1,5 2,5 3,5 1,5 2,5 3,5 1,5 1,5 2,5 3,5 1,5 2,5 3,5 1,5 2,5 3,5 1,5 2,5 3,5 1,5 2,5 3,5 1,5 2,5 3,5 1,5 2,5 3,5 1,5 2,5 3,5 1,5
1,4 2,4 3,4 1,4 2,4 3,4 1,4 2,4 3,4 1,4 2,4 3,4 1,4 2,4 3,4 1,4 2,4 3,4 1,4 2,4 3,4 1,4 2,4 3,4 1,4 1,4 2,4 3,4 1,4 2,4 3,4 1,4 2,4 3,4 1,4 2,4 3,4 1,4 2,4 3,4 1,4 2,4 3,4 1,4 2,4 3,4 1,4 2,4 3,4 1,4
1,5 2,5 3,5 1,5 2,5 3,5 1,5 2,5 3,5 1,5 2,5 3,5 1,5 2,5 3,5 1,5 2,5 3,5 1,5 2,5 3,5 1,5 2,5 3,5 1,5 1,5 2,5 3,5 1,5 2,5 3,5 1,5 2,5 3,5 1,5 2,5 3,5 1,5 2,5 3,5 1,5 2,5 3,5 1,5 2,5 3,5 1,5 2,5 3,5 1,5
1,4 2,4 3,4 1,4 2,4 3,4 1,4 2,4 3,4 1,4 2,4 3,4 1,4 2,4 3,4 1,6 2,6 3,4 1,4 2,4 3,4 1,4 2,4 3,4 1,4 1,4 2,4 3,4 1,4 2,4 3,4 1,4 2,4 3,4 1,4 2,4 3,4 1,4 2,4 3,4 1,6 2,6 3,4 1,4 2,4 3,4 1,4 2,4 3,4 1,4
1,5 2,5 3,5 1,5 2,5 3,5 1,5 2,5 3,5 1,5 2,5 3,5 1,5 2,5 3,5 1,5 2,5 3,5 1,5 2,5 3,5 1,5 2,5 3,5 1,5 1,5 2,5 3,5 1,5 2,5 3,5 1,5 2,5 3,5 1,5 2,5 3,5 1,5 2,5 3,5 1,5 2,5 3,5 1,5 2,5 3,5 1,5 2,5 3,5 1,5
1,4 2,4 3,4 1,4 2,4 3,4 1,4 2,4 3,4 1,4 2,4 3,4 1,4 2,4 3,4 1,4 2,4 3,4 1,4 2,4 3,4 1,6 2,6 3,4 1,4 1,4 2,4 3,4 1,4 2,4 3,4 1,4 2,4 3,4 1,4 2,4 3,4 1,4 2,4 3,4 1,4 2,4 3,4 1,4 2,4 3,4 1,6 2,6 3,4 1,4
1,5 2,5 3,5 1,5 2,5 3,5 1,5 2,5 3,5 1,5 2,5 3,5 1,5 2,5 3,5 1,5 2,5 3,5 1,5 2,5 3,5 1,5 2,5 3,5 1,5 1,5 2,5 3,5 1,5 2,5 3,5 1,5 2,5 3,5 1,5 2,5 3,5 1,5 2,5 3,5 1,5 2,5 3,5 1,5 2,5 3,5 1,5 2,5 3,5 1,5
